username	first_name
kprugel0	Ki
blonnon1	Bruno
gphilcott2	Genevra
abruggeman3	Ailene
larndell4	Lind
atoffanini5	Antin
nabsolon6	Nat
tmellmer7	Tasia
nsalzberg8	Nahum
castall9	Charo
malbanya	Manny
iharloweb	Ivette
smoorrudc	Shaylyn
kcoppeardd	Kessiah
vsiemantele	Veradis
twerrettf	Travis
mratieg	Maurene
temerineh	Tracie
apullini	Ansel
bvamplersj	Brittani
vemesk	Vikki
cnorthingl	Cheston
lnewberym	Levin
apouldenn	Averill
rabbeto	Rouvin
fjoskowitzp	Frederique
draffinq	Damian
cmcilwainr	Camila
gsneakers	Glory
jhlavact	Jennilee
rbriandu	Rowen
gvandrillv	Gran
gwhybornw	Giorgi
tdomnineyx	Thaine
lpetraceky	Loella
okachelerz	Orson
groblett10	Gelya
kverring11	Kristos
ksheeran12	Kristine
dtirrey13	Damita
emoxom14	Euphemia
mgladden15	Morna
nkaser16	Nichole
cpauleau17	Charis
reates18	Rochette
ainnis19	Agnese
kiffe1a	Kala
baveries1b	Benny
lrubinek1c	Luella
jbonehill1d	Jamie
cpigram1e	Celinda
dbobasch1f	Dalli
bfellona1g	Bethina
sgazey1h	Star
larnaud1i	Lorinda
jmattek1j	Jewell
rramage1k	Rustin
jtotman1l	Julietta
cgoodhall1m	Candida
tbottoner1n	Thibaut
rcompson1o	Rusty
pgeary1p	Paton
abrinded1q	Aleksandr
cbuey1r	Clemmy
cgulliver1s	Carine
lwignall1t	Lidia
istanyon1u	Ileane
cswigger1v	Carlene
mcholwell1w	Maiga
smazzia1x	Sven
flambden1y	Fulton
cchapell1z	Cyndy
dsyversen20	Deana
bparks21	Bartolemo
ljowers22	Loy
gply23	Gwyneth
avignal24	Aurora
evyvyan25	Elayne
gchafney26	Giovanna
akleinplac27	Alexandre
dwrotchford28	Dayna
bfairbard29	Benedick
esprigging2a	Edith
ecambridge2b	Emeline
gmccauley2c	Glynn
vdanielou2d	Vitia
abrabant2e	Anjela
ahartman2f	Aurelie
hlansberry2g	Honor
mgirth2h	Mozes
landrioletti2i	Letisha
ahungerford2j	Alec
bpenson2k	Bo
cstaziker2l	Crista
amcaster2m	Alie
gbeauman2n	Gifford
heasson2o	Huey
apenswick2p	Ariadne
rjory2q	Ronni
arome2r	Alex
smarples2s	Skyler
fnerval2t	Ferdinanda
dthumnel2u	Dylan
bramsbottom2v	Brandi
fkidner2w	Florie
lplester2x	Lorette
cshipp2y	Clifford
flowthorpe2z	Fidelio
tstillgoe30	Thornie
ftreker31	Florie
ostreather32	Odey
dheyward33	Donaugh
vkuhnwald34	Viola
mbowhay35	Mal
mchaytor36	Maritsa
dilyuchyov37	Dede
sromanetti38	Sutherland
aweall39	Arne
tgiacomelli3a	Tasha
vfashion3b	Vernice
aogarmen3c	Aeriel
gminillo3d	Gene
atalbot3e	Ara
cwasielewicz3f	Curtis
gblase3g	Gale
wdrewitt3h	Winifred
xjeffcoat3i	Xavier
halbone3j	Hazel
chilling3k	Corella
lcaddan3l	Lanie
aedgar3m	Alair
hchurchill3n	Heddi
ebidmead3o	Ellynn
drusling3p	Dewey
adannett3q	Allyce
bhailey3r	Bartlet
jburlingham3s	Jobyna
asmurthwaite3t	Anallise
lgane3u	Lucien
hpudge3v	Haze
cmartygin3w	Constantino
sdyte3x	Samson
jreynault3y	Justinn
rgavini3z	Rodger
rroomes40	Randie
cslaten41	Celestina
hmcbride42	Harri
fgelly43	Fanya
amauditt44	Ardelia
zbastin45	Zacherie
aeastope46	Annabel
sabbots47	Sandie
gfulleylove48	Gunner
origgs49	Olly
acatt4a	Amie
aschenkel4b	Augustina
lwhelpdale4c	Linea
dcopnell4d	Doro
gdanford4e	Gaye
bcoupar4f	Beale
dtinghill4g	Dayna
jpiffe4h	Jodi
volney4i	Vaclav
hpaul4j	Hally
elovick4k	Ewan
lberndt4l	Lisetta
nfaudrie4m	Nanon
cemtage4n	Catrina
khoston4o	Kerstin
twarlawe4p	Temple
rhartell4q	Rayshell
llillicrop4r	Latisha
rfysh4s	Rosanne
cbigby4t	Clarie
hcolcutt4u	Harriet
fshawel4v	Ferdy
sbonnin4w	Sharla
eramelet4x	Elvis
adorricott4y	Anthe
rguilfoyle4z	Roley
msmallwood50	Mattie
ccansdill51	Calla
sklesse52	Sadie
cbruggen53	Chauncey
amcpartling54	Abbi
eneeve55	Elliott
gmocher56	Goldina
kmcsweeney57	Kerrill
jremnant58	Jaine
adenington59	Ailyn
vmurrum5a	Vina
thenrichs5b	Tabby
ltathacott5c	Ludovika
htaggett5d	Holly
rburges5e	Rolando
mgowen5f	Muriel
cshatford5g	Cheryl
pgaraghan5h	Paco
aelsegood5i	Adaline
mtuffley5j	Miquela
cdonwell5k	Cathy
jbendin5l	Janel
dbarbera5m	Deana
ezamorano5n	Eddy
backland5o	Bobbee
ksisneros5p	Kalli
mtague5q	Mae
mbeamson5r	Miller
mgallegos5s	Melinda
sdelph5t	Sancho
nstorer5u	Natividad
mcrisford5v	Margarette
mbeavers5w	Matty
hjosef5x	Hermon
sliggett5y	Sidnee
dfigures5z	Dave
rblindermann60	Raeann
callan61	Curtis
wmandrier62	Willy
gforesight63	Ginny
ffalco64	Freida
rgurg65	Raphael
mcoverdill66	Merrielle
rcrisell67	Ronalda
cbedminster68	Cornall
edow69	Emmerich
kbiggins6a	Kania
csivyour6b	Claiborne
bdudliston6c	Burch
ctizzard6d	Cozmo
phails6e	Parnell
jcarolan6f	Jordan
jcawson6g	Jan
pcoat6h	Panchito
ejorg6i	Eudora
tjukes6j	Tiffy
jklaussen6k	Jeniece
rpollen6l	Roz
dbenck6m	Darsey
glearoyd6n	Gayler
fszymon6o	Filmore
imillions6p	Izabel
jcummine6q	Jard
bwhitely6r	Bud
alushey6s	Abagail
cbedell6t	Casi
psouthcoat6u	Pincus
wrasher6v	Webb
bthinn6w	Briano
fayers6x	Fayre
ctook6y	Candida
aquinnell6z	Alyssa
emacdwyer70	Etti
ajowsey71	Alfie
rperrot72	Ranique
adallow73	Antonina
bmathou74	Bucky
beberdt75	Bernetta
rgallally76	Rockey
dtrench77	Dede
rcroy78	Ranique
rbruff79	Roddy
ichetwind7a	Ignace
bnewland7b	Branden
rtocknell7c	Rutter
bbrecher7d	Babbie
rbottjer7e	Rori
tchard7f	Torey
bescritt7g	Brittani
jstanner7h	Jennifer
nmacgebenay7i	Noam
wroskruge7j	Wernher
soleshunin7k	Simonette
soboy7l	Sibylla
pvince7m	Polly
sbalden7n	Sybil
vstennings7o	Vyky
aryley7p	Aldwin
bkolczynski7q	Benoite
wharmon7r	Wendie
etort7s	Evangeline
vswafield7t	Valentin
cfoxcroft7u	Celine
ogwillim7v	Osbert
mavo7w	Morna
mstook7x	Meridith
mguyver7y	Mahmud
ghevner7z	Gaven
lbocking80	Lalo
cmazey81	Chrisse
hdoghartie82	Harmonie
rgjerde83	Randee
dbremond84	Delores
rhatherell85	Rois
kwyllis86	Krystal
acanniffe87	Artus
sconnue88	Scarlet
nandrusyak89	Nettle
ksrutton8a	Katherina
taisman8b	Terri
cgaule8c	Casie
ggatcliff8d	Gayla
rstenbridge8e	Rorie
lcowherd8f	Laureen
pakroyd8g	Pattie
cwattins8h	Cele
abeggs8i	Adriano
dorkney8j	Dennison
alane8k	Ariela
jblakeley8l	Jesus
jallward8m	Joceline
lkirkpatrick8n	Lianne
dwoodeson8o	Dominica
asainz8p	Aloisia
cbeakes8q	Chryste
apulham8r	Avram
tshearer8s	Tamas
lhonywill8t	Latrina
lbrekonridge8u	Leta
ldate8v	Letti
nfoddy8w	Nickolas
asire8x	Abbi
gkisar8y	Glad
hsorrell8z	Homerus
hruddock90	Heidie
djeandet91	Dorey
dwardingly92	Darill
etackle93	Ellery
iarchibould94	Ilene
pcoyett95	Packston
smillan96	Sanders
sfyfield97	Shandie
derbain98	Dunn
mglashby99	Mufi
mainslee9a	Molly
hgoshawk9b	Hugh
rcockney9c	Rene
sdadley9d	Sanford
afehners9e	Amabel
panneslie9f	Pattie
lbernaldo9g	Lily
esarchwell9h	Evanne
tharbert9i	Tilly
ebushrod9j	Emmie
ghedaux9k	Gayla
gbolding9l	Greg
taiton9m	Tailor
nricks9n	Norry
ajiru9o	Aline
cwoollacott9p	Chrystal
gforte9q	Gregoire
yhaldon9r	Yoshiko
gallflatt9s	Giselle
cshillitoe9t	Carson
krymour9u	Kellina
feverson9v	Florella
egribbin9w	Ellswerth
bclink9x	Blinnie
oaird9y	Odilia
nalders9z	Noreen
bstithea0	Bette-ann
atomaa1	Alli
omcinilitya2	Osmund
elevanea3	Ernst
blonglandsa4	Benedick
rbettesona5	Rosetta
wmeatesa6	Waldemar
lfynesa7	Lilith
gmoxsteada8	Grange
dpykermana9	Danell
acreeberaa	Ainslie
dbaptisteab	Davis
vghilardiac	Velvet
nskaifead	Nikos
gelgoodae	Giustino
twidgeraf	Trey
nmayheadag	Norri
cbriffettah	Curry
glissamanai	Genni
tspinasaj	Tuck
akintzelak	Alexander
eamaral	Eugene
miglesiazam	Marlene
rhaslochan	Rhianna
teastmanao	Tabb
llaguerreap	Lawton
rtevelovaq	Row
sballhamar	Stephi
rtindleas	Raynell
nbrisseauat	Norma
shevnerau	Shandie
twildtav	Townsend
cmionaw	Caresse
jcappsax	Johnnie
tanthiftleay	Torin
aaugaraz	Ardelle
rcapelowb0	Roxane
lgaskenb1	Livvy
pregardsoeb2	Parker
deberzb3	Dori
triggollb4	Tobie
eprettymanb5	Emelyne
udearloveb6	Ulrikaumeko
clogueb7	Caroljean
vgeraudelb8	Valentin
rvilliersb9	Randi
falexandrouba	Farah
abeangebb	Alexine
rsloambc	Rikki
ltremmilbd	Loria
qkemsleybe	Quinn
dsidneybf	Diego
aimlochbg	Alonso
nheminsleybh	Nappy
zstannusbi	Zara
psimysonbj	Perice
rtredgetbk	Rufe
grollesbl	Goddard
amcculloughbm	Alyse
jraubenheimersbn	Jannelle
lkiddiebo	Lavinie
bcoughtreybp	Belicia
dfredebq	Duffy
edavidaibr	Elissa
kspurriarbs	Kathe
ewilcotbt	Estel
dolenchenkobu	Dinah
ssimkissbv	Shawn
anarramorebw	Aaren
jbluemanbx	Junette
fcristofvaoby	Franky
eworlandbz	Ernie
elaugheranc0	Evyn
srustc1	Shayne
rcristofaroc2	Riannon
lgunnc3	Lidia
hnottinghamc4	Helge
shuleattc5	Sherwood
ljanauschekc6	Lise
ccleminshawc7	Camella
bbickerdykec8	Bailie
olongthornec9	Orlando
ppeeleca	Pat
asilvermanncb	Annice
kbrigdencc	Kristi
cwiddowsoncd	Christian
broscriggce	Betti
mtwellscf	Mirna
fscapenscg	Fallon
tskatech	Tedd
fcorhardci	Felizio
jlidgertwoodcj	Jakie
pbeeseck	Patton
jgiblingcl	Jacklin
ajavescm	Adrianna
coleszkiewiczcn	Carly
mdanaherco	Mickie
lwilsteadcp	Leontine
sskillerncq	Sunshine
mcorrycr	Mabelle
ndundincs	Nixie
iminghellact	Imogene
rmitchensoncu	Rickard
cchislettcv	Clerkclaude
btideswellcw	Boniface
kroysoncx	Kleon
rsawleycy	Rosabella
pmccallumcz	Phip
nkerryd0	Nate
chiggoed1	Coralie
croomed2	Claudie
msodod3	Marion
adorewardd4	Annamaria
kroelsd5	Keith
mlemasneyd6	Montgomery
cpaddied7	Chiquia
jcucksond8	Jena
mtauntond9	Mamie
aidneyda	Antoinette
brigatedb	Brig
bbreckendc	Brooke
cfraniesdd	Carla
jhurdisde	Jan
kgansbuhlerdf	Kendrick
rlamblindg	Roman
ecoogandh	Eugene
ajanikowskidi	Alysia
mmedendorpdj	Moira
cgiovanninidk	Cassandry
tsomnerdl	Thadeus
adowreydm	Artus
cjermandn	Callie
tmackettrickdo	Thain
wguinanedp	Willie
fyanovdq	Fletch
eabramamovdr	Emmanuel
easpinalds	Elayne
ggartenfelddt	Guthrey
cpargeterdu	Cyndie
emathousedv	Ealasaid
pautindw	Penelopa
agorssedx	Allister
lchelamdy	Lianne
ccollomossedz	Clark
akettoee0	Ashly
ajenninse1	Arvy
dduleye2	Donia
hpepalle3	Hedda
jlearoide4	Josy
skneathe5	Spence
aflickere6	Alena
gmacgillespiee7	Grantham
cohoeye8	Carolee
bfearne9	Batsheva
karntzenea	Karia
ghandrikeb	Garrot
akupkeec	Amabelle
msimchenkoed	Maisie
ccastanosee	Chadwick
rmadsenef	Rosella
mstandeneg	Morton
ybartoteh	Yasmin
cpavlovicei	Cornell
mmattiazziej	Mattheus
srubiek	Sidoney
ckeevesel	Cris
vlegonem	Vite
gcranfielden	Guy
nwalbrookeo	Nettie
scinnamondep	Sheffie
cshoutteq	Cherilyn
perbeer	Pearce
jmeynelles	Jacenta
mdanilyaket	Maddy
krunseyeu	Katheryn
lekkelev	Leif
kwoehlerew	Kelwin
lgreimex	Lizzie
ckeoghey	Cornie
pdeekesez	Peggi
challgoughf0	Cele
rburminghamf1	Rufus
dsettlef2	Dede
amccrorief3	Armando
ayantsurevf4	Aliza
mmatejf5	Marya
slampsf6	Stillman
lleflemingf7	Linnell
dduplantierf8	Dagmar
bchapelhowf9	Bernie
mallanbyfa	Malva
njosipovitzfb	Nixie
rpadulafc	Rufe
fbaggarleyfd	Fionnula
cbendinfe	Catherin
hnelseyff	Hephzibah
yawcoatefg	Ynez
nmulcockfh	Niven
drathmellfi	Davey
cklimashevichfj	Caspar
adoyfk	Annie
sadamoufl	Sayre
bbickerstaffefm	Betty
omccoyfn	Oriana
dparsandfo	Donnie
aarklefp	Alfredo
rdurbridgefq	Roi
mthumannfr	Maible
bmattersonfs	Bernette
fnutbeamft	Farris
dvallentinefu	Dita
awallsamfv	Arlin
cmeahfw	Cody
cohengertyfx	Chalmers
dbloxsumfy	Dorise
ftizardfz	Fulvia
hhowieg0	Harriot
gmcsperrong1	Gunilla
erushtong2	Elisabet
areekg3	Alyssa
mscreechg4	Maura
aodoghestyg5	Annora
bbrusterg6	Bordy
tmartyng7	Tamqrah
lbartolg8	Lee
bwittringtong9	Brunhilde
ccomolettiga	Claudelle
kbichardgb	Kakalina
bpielgc	Byron
kturviegd	Karyn
cpetrassoge	Currey
kguyetgf	Kyla
cbergstramgg	Clari
heglesegh	Humfrid
ncamingsgi	Nancy
mlavalgj	Marguerite
tmanchettgk	Taddeusz
msotherngl	Maxie
khaineygm	Kelvin
rguyetgn	Rory
chainsgo	Cherie
jmeehangp	Josey
skaveneygq	Shirlee
glivezeygr	Gabriel
kscudamoregs	Killian
snovellogt	Sam
cferraigu	Chico
helpheygv	Hakim
lbedlegw	Luce
obuschgx	Ortensia
mmcguineygy	Margaret
mbattramgz	Mirella
fcorsarh0	Farley
cbielfeldh1	Cyndie
mghironh2	Marylee
gfourmyh3	Gordy
afrauloh4	Afton
aruppeleh5	Ardenia
bbritchh6	Bernie
ftichelaarh7	Freda
jfurseh8	June
gburleh9	Gerri
jrushbyha	Jane
tlemmehb	Tim
mjorehc	Mitchel
nmayberryhd	Nathaniel
bpaulleyhe	Bernadene
ilemarquandhf	Ingar
iprivetthg	Issy
fbennoughhh	Forester
gcolliberhi	Garvy
pskocrofthj	Prudi
molensbyhk	Marja
lstepneyhl	Lynda
ghallgatehm	George
skelleherhn	Starlene
mmulbryho	Matthieu
sratnagehp	Sheridan
mbostickhq	Mag
skenwortheyhr	Sibyl
hcashellhs	Hall
rbuncherht	Read
brosenblumhu	Barb
jstreaderhv	Jake
lcolebournehw	Linnell
nmaestrinihx	Nathaniel
ewheeltonhy	Eydie
rpilleyhz	Rafa
pgosnolli0	Penrod
tzemleri1	Tarra
chuardi2	Corbin
mmcfadyeni3	Monika
ksparkei4	Klarika
cpetoi5	Clyve
ejanotai6	Elysha
gcruisei7	Germaine
atreacyi8	Amye
moscanloni9	Marcos
globia	Gaby
vkennewayib	Venus
jtuisonic	Jobie
cdaviesid	Camile
mrishworthie	Marylynne
kcopnellif	Kippy
wphillcoxig	Waylan
dfurbyih	Durant
ctrewhelaii	Chiquia
spalethorpeij	Susan
hhakingik	Helenelizabeth
ceyreil	Con
jyosevitzim	Jarret
garrowsmithin	Goran
mcrownshawio	Marjy
arootip	Aguste
bdmiterkoiq	Bellanca
dkohnemannir	Decca
mcofaxis	Merrile
kstrotherit	Kev
bstevaniiu	Bryn
lridsdoleiv	Lea
tgladmaniw	Tobi
ihartwrightix	Iona
mfortescueiy	Marlow
wcapelliz	Wanids
skleinlererj0	Sindee
kgillebertj1	Kathryn
gklussj2	Gavrielle
dchurchinj3	Deeanne
ajorij4	Ad
sworrellj5	Sharia
fwolffersj6	Friederike
bhillsj7	Benedikt
ocaudlej8	Oralle
cvalej9	Caldwell
lcomettoija	Lucine
fgerdingjb	Fernandina
atottonjc	Alethea
cgadsdonjd	Catlin
lquerrardje	Land
ashawcrossjf	Ariadne
kmccereryjg	Kristopher
narpjh	Nata
zthurlbeckji	Zorah
owestripjj	Olin
yspittalljk	Yvette
glumsdenjl	Gael
asabaterjm	Ardis
ajessopejn	Aksel
gmulhalljo	Giordano
kokerinjp	Keir
bplumsteadjq	Berget
chovyjr	Clarke
bdronsfieldjs	Brose
skubczakjt	Staford
hroebottomju	Humfrid
pwillbondjv	Pembroke
tisworthjw	Taddeusz
hmarcinkowskijx	Harriett
mfeekjy	Mano
lmcelreejz	Leticia
erushburyk0	Edgardo
bdeyek1	Beth
nblenchk2	Nixie
aattenboroughk3	Adi
jsandercockk4	Johan
sfruddk5	Scot
erobillardk6	Eda
vnaerupk7	Virgie
ctorfink8	Chauncey
apencottk9	Alvina
acasottika	Annabela
mvauxkb	Malachi
cdelaeglisekc	Clementia
wsteynorkd	Wylma
ideruelke	Igor
pklinerkf	Pattie
hmouldskg	Hephzibah
sturlekh	Shelden
bchaineyki	Bailie
cjurkiewiczkj	Carlos
wmarcombekk	Walker
odraytonkl	Olympia
bbaserkm	Benyamin
ystubbingtonkn	Yul
ilowselyko	Irena
fyauskp	Federica
lilettkq	Leslie
bgorhardtkr	Batholomew
weverillks	Walker
mpinnigerkt	Missy
kgombyku	Kara
eormondekv	Elli
bsimonitekw	Bondy
sredonkx	Storm
pstuddalky	Peggie
kshireffkz	Kristal
igowenl0	Isidora
jradmorel1	Jeremie
ctomblesonl2	Callean
mhallybonel3	Malcolm
apinningtonl4	Alisander
cberzenl5	Constantia
mloderl6	Marrilee
acaswelll7	Annabelle
pprimarolol8	Pauletta
amacgovernl9	Andre
rbraidmanla	Rustie
bbrenardlb	Barbabas
mchadlc	Mattie
nkillingbeckld	Nial
blebatteurle	Bobbye
sseppeylf	Shari
mwatsamlg	Marlin
wpetrosianlh	Winna
ldelueli	Lynna
lcorpelj	Louisette
ldunnanlk	Laurel
dmcgregorll	Dougy
hmabeelm	Hilly
ndickonsln	Noelle
lhuglelo	Link
mpinfoldlp	Megen
plenoxlq	Pammy
bkittleylr	Bethanne
cmighelils	Costanza
severingtonlt	Sonny
mloosemorelu	Margret
phuggettlv	Phil
ebarnwilllw	Eugenio
gmonetilx	Gwenora
dkieransly	Diann
apoletlz	Adelaide
pbeartm0	Phillipp
efranzinim1	Ellie
hkilgrovem2	Harmonia
vjorim3	Vilma
pbayntonm4	Philippine
aphilliskirkm5	Arlie
ktwelvetreem6	Keri
rmctavym7	Robenia
zscholefieldm8	Zabrina
htroddenm9	Helaina
mbernardezma	Moyna
efrankcommb	Eddie
tfassmanmc	Thorn
bmerlinmd	Benedikt
alownsbroughme	Alf
tyakovlmf	Timothy
dvollammg	Damien
gwebbmh	Gal
emcilvennymi	Emlynne
kmaseymj	Kinsley
ceayresmk	Ced
lbrabbsml	Loralee
omulfordmm	Olivier
ftunnadinemn	Frasquito
bhorleymo	Brig
aaubinmp	Annora
mgrzegorekmq	Mitchell
bfrudemr	Bella
fmcinilityms	Fae
dagusmt	Demott
croseboroughmu	Corty
rcousansmv	Rutger
tpeplawmw	Tory
asidnellmx	Ana
skleinmintzmy	Shep
vomullanemz	Vonny
esavinen0	Elroy
krandalstonn1	Kissie
mmontn2	Margalit
lcreedn3	Lonni
cjanikowskin4	Ciro
praultn5	Petronilla
bmarsien6	Brandy
pcarniern7	Prentiss
egilbeen8	Earvin
mhartfordn9	Maxie
tscrippsna	Thornton
sluciennb	See
gcolhounnc	Guthry
mstarkiend	Monah
bsignne	Benjamen
dabdennf	Darcey
cligerng	Cletis
pframminghamnh	Penny
gaddsni	Gerianne
tciraldonj	Tommy
lcarnienk	Lenore
gbarfootnl	Geraldine
mlorentenm	Monroe
lmcgaugheynn	Livvy
cwynneno	Curt
chartoppnp	Calli
jvannuccinq	Jaquenetta
dwhistonnr	Deeann
rcominins	Rhodie
jfeatenbynt	Jacquenetta
wjacmarnu	Wait
bbutterleynv	Brittaney
bleathwoodnw	Brandise
ffeatonbynx	Fancy
sgresny	Shepperd
tbrunnnz	Timi
raronovo0	Rosina
jcornewallo1	Joscelin
aclealo2	Amata
glilloeo3	Gwenora
nsmewingso4	Nancey
dchrispino5	Darill
erollinshawo6	Ericka
bgotecliffeo7	Bibbie
ggiberdo8	Gabbey
dbrimmano9	Danyelle
maldridgeoa	My
ggriseob	Gunter
chansenoc	Conrad
cterronod	Corabel
bslocumboe	Beatrice
khowsinof	Kathy
tbrazerog	Thorstein
mkimmonsoh	Merralee
shoffmannoi	Stearn
cmattiellioj	Constantine
adidballok	Ashlie
nephgraveol	Nevin
jagettom	Jessika
etilburnon	Emery
ckemmettoo	Cassondra
tampsop	Tris
csillyoq	Christie
ppolonor	Prissie
caingelos	Cornelia
skaysot	Scott
icorssenou	Ichabod
ajonssonov	Alexa
bdennistounow	Bell
askitchox	Avrom
mhelmoy	Mariya
lhubbleoz	Laraine
battackp0	Broddy
dlayzellp1	Dianna
jblampyp2	Josh
cpauluschp3	Charley
hbrumwellp4	Hertha
eroskelleyp5	Erroll
hhuckelp6	Henrie
hpeatheyjohnsp7	Hillary
sbinnellp8	Sheila-kathryn
klemmep9	Katey
kputsonpa	Kissiah
lbarclaypb	Laura
tgiamellipc	Tab
igooddypd	Irita
amerriottpe	Arabelle
cjodrellecpf	Constance
vleeuwerinkpg	Virgie
estanesbyph	Euphemia
ngrimestonepi	Norah
gokeavenypj	Geoff
jmaharrypk	Jessie
thopkynspl	Tabby
ayeskinpm	Allene
csevernpn	Cymbre
cdonnerpo	Caleb
ckopkepp	Cosimo
lleydonpq	Lonnie
searleypr	Susy
avaggesps	Antonino
mcristofanopt	Mendy
blemanupu	Brad
mdraytonpv	Mitzi
jgorchpw	Jordon
jbrilpx	Josee
pdoickpy	Pearle
lwaddypz	Lorry
nkermitq0	Ninnetta
jbasfordq1	Janice
snoniq2	Shauna
lfliggq3	Lina
plangtryq4	Pembroke
fofallowneq5	Frederik
gbarstockq6	Gill
kdebrettq7	Kris
gmcgurganq8	Guglielmo
ghargraveq9	Gilbert
pdymockeqa	Puff
lgeartyqb	Lyon
emckeefryqc	Elyse
lgaytorqd	Liane
sdillimoreqe	Simonette
nshinglerqf	Nat
adayborneqg	Auberon
jkeffordqh	Jeramie
akippieqi	Artair
elorneqj	Erroll
holesenqk	Harald
clillicrapql	Candi
ayoseloffqm	Athena
tstigersqn	Travus
rgoldsbroughqo	Roy
gmacallanqp	Georgie
merbqq	Malinde
bdriversqr	Birch
ocookleyqs	Oralia
gcolyerqt	Garwood
cvinerqu	Cari
hsmallqv	Hillyer
adowbakinqw	Avie
mliversleyqx	Melitta
ljeandonqy	Lacy
blingerqz	Brocky
rfritchleyr0	Raina
kjeppensenr1	Kaine
dparnallr2	Donnell
gcharrissonr3	Glenn
lladloer4	Leonhard
cpieler5	Calhoun
lmidlarr6	Loren
rmalkinr7	Rianon
jstolter8	Jerrilee
lgillicuddyr9	Lavinia
vboschmannra	Venus
mfarlowerb	Marijn
abellochtrc	Andria
kgilhouleyrd	Krystyna
lsimeonere	Laird
mruossrf	Marissa
dcongreverg	Denise
skenanrh	Sibelle
fmuckianri	Flory
lperrierj	Lazare
whugeninrk	Willdon
bmorstonrl	Barnabas
vdaykinrm	Vladimir
efloyedrn	Edik
fshadfourthro	Frederik
lkynanrp	Lissa
kpillingrq	Kiah
ddevenportrr	Doug